111111111111111111111111111111111111111111111111111111111111
1C1000111101000C0000C00000000000000CC000000000000C000000C001
1010101C0001011111111111111111111111111111111111111111111001
1010100010010100C000000000000C000000000000000000000000001C01
1011111110100101111111111111111111111111111111111111111010C1
100000010010010100000000CCCCCCCCC000000000000000000000101001
101110100100010101111111111111111111111111111111111110101C01
1000100010000101010000000000000000000000000000000000101010C1
11000111C010010101000111111111111111111111111111100010101C11
10010C0101100101010000001111111110000000000000000000101010C1
110101000010010101000000000000000000001111111111100010101C01
1001011111100101001111111111111111100000011111111100101011C1
101101000010010010011000011000100001001110011111110010101C01
10010C0001110010010000110000100011001000110011111100101010C1
110111100101001100111111111111110010100000000011110010101C11
1001111111010C011000C0000000C0000P10011000110001110010100101
1011111101010100110C0010010000011011000010001000010010101001
10011111E1010110001100C01C1000110000110C01100110000010101001
110111110101001100011000000001100111101100010001100010100101
1C0000000101000110001100110011000000000111000100010010101001
101111111101000011000110000110011111110111110011001110101001
101010000001000001100011CC1100100000010000001000100000101001
101000101111000000110001111001001111011110110110011111101001
10101010100111110011100000000001000000100C000011000000001001
101010100100000000000001111111101011111111100011111101101001
101010100111111101111111000000011001100001111100001001001101
101010010100000101CCCCC1011111C10100000100001001001010000011
101011010101111001CCCCC1000000000000011001001001001111111011
101010011000000011CC1CC1111111111111100010010011000000000001
100010001111111111CCCCC1000001100000000100100100111111111101
1C1001100000000000CCCCC00100001100000010000010000000000000C1
111111111111111111111111111111111111111111111111111111111111